################
#   ############
#  $ ### .######
# $   $  .######
## $#####.######
# $  ### .###  #
#    ### .#  @ #
###  ###       #
#########     ##
################
