           #
          # #
         #   #
        #  *  #
       #  * *  #
      #  * $ *  #
     ## * $#$ * ##
    #  . * $ * .  #
   #  * . * * . *  #
  #  * * . * . * *  #
 #  * $ * . . * $ *  #
#  * $#$ * @ * $#$ *  #
 #  * $ * . . * $ *  #
  #  * * . * . * *  #
   #  * . * * . *  #
    #  . * $ * .  #
     ## * $#$ * ##
      #  * $ *  #
       #  * *  #
        #  *  #
         #   #
          # #
           #
