                     #
                    # #
                   # # #
                  #  *  #
                 #  * *  #
                #  * $ *  #
               ## * $#$ * ##
              #  . * $ * .  #
             #  * . * * . *  #
            #  * * . * . * *  #
           #  * $ *  #  * $ *  #
          ## * $#$ *   * $#$ * ##
         #  . * $ *  #  * $ * .  #
        #  * . * * . * . * * . *  #
       #  * * . * . * * . * . * *  #
      #  * $ *  #  * $ *  #  * $ *  #
     ## * $#$ *# #* $#$ *# #* $#$ * ##
    #  . * $ *  #  * $ *  #  * $ * .  #
   #  * . * * . * . * * . * . * * . *  #
  #  * * . * . * * . * . * * . * . * *  #
 #  * $ *     * $ * . . * $ *     * $ *  #
# #* $#$ *# #* $#$ * @ * $#$ *# #* $#$ *# #
 #  * $ *     * $ * . . * $ *     * $ *  #
  #  * * . * . * * . * . * * . * . * *  #
   #  * . * * . * . * * . * . * * . *  #
    #  . * $ *  #  * $ *  #  * $ * .  #
     ## * $#$ *# #* $#$ *# #* $#$ * ##
      #  * $ *  #  * $ *  #  * $ *  #
       #  * * . * . * * . * . * *  #
        #  * . * * . * . * * . *  #
         #  . * $ *  #  * $ * .  #
          ## * $#$ *   * $#$ * ##
           #  * $ *  #  * $ *  #
            #  * * . * . * *  #
             #  * . * * . *  #
              #  . * $ * .  #
               ## * $#$ * ##
                #  * $ *  #
                 #  * *  #
                  #  *  #
                   # # #
                    # #
                     #
