       ####  ######
      ##  ####    #
#######  *   #$ $ #
#.....#  *# $ $ $ #
#.##*.# # # $ $ $ #
#..#..# # # $ $ $ #
#.*#*.# # # $ $ $ #
#..#..# # # $ $ $ #
#.*#*.# # # $ $ $ #
#..#..# # # $ $ $ #
#.*#*.# # # $ $ $ #
#..#..# # # $ $ $ #
#.*#*.# # # $ $ $ #
#..*..# # # $ $ $ #
#.***...  # $ $$$ #
#   #######      @#
#####     #########
